0 0 0 0 0 0 0 3 0
7 5 0 0 8 4 0 9 6
2 0 0 0 0 6 0 0 5
0 0 4 0 0 8 0 6 0
0 0 2 4 1 5 0 7 0
0 0 5 7 0 0 0 0 0 
5 3 1 6 7 0 0 0 4
6 0 9 0 3 0 2 5 7
8 0 0 5 4 9 6 0 3

6 9 0 0 0 0 7 0 0
0 0 0 0 9 6 0 0 0
0 8 0 7 5 3 0 9 0
0 2 0 3 7 4 5 6 1
3 6 0 0 0 5 0 2 0
0 0 0 9 6 0 3 7 8
0 0 6 0 3 1 0 8 4
0 4 5 8 0 7 6 0 0
0 0 0 0 0 0 0 5 7

7 6 0 0 0 0 0 0 0
0 5 0 0 0 0 8 2 0
0 0 0 2 0 7 0 4 0
0 0 0 0 9 6 7 0 0
0 3 0 0 0 0 0 1 0
0 0 0 8 0 0 0 0 0
2 0 0 0 0 1 3 0 0
1 0 0 0 0 0 9 6 0
0 7 0 0 0 9 0 0 5